1111111111111111
1PC0000000000001
11111E1111111111
1000000100000001
100C0C0000000001
1000100000000001
1000000000000001
1000000000000001
1011111111111111
1000000000000001
1111111111111101
1C00000000000001
1111111111111111