1111111111111111
1PC00000000000E1
1111011111111111
1000000100000001
100C0C0000000001
1000100000000001
1000000000000001
1000000000000001
1011111111111111
1000000000000001
1111111111111101
1000000000000001
1111111111111111