1111111111111111
10000000000C1E01
10PC000000001101
1000000100000001
100C0C0000C00001
1000100000000001
10000C0000010001
10000000000000C1
1011111111111111
1C00C00C00C00C01
1111111111111101
1C00C00C00C00C01
1111111111111111