1111111111111111
1000000100000001
1PC00000000000E1
1111111111111111