1111111111111111
1000000000001E01
10P0000000001101
1000000100000001
1000000000000001
1000100000000001
1000000000010001
1000000000000001
1011111111111111
1C00C00C00C00C01
1111111111111101
1C00C00C00C00C01
1111111111111111