1111111111111111
1PC00000000001E1
1111111111111111