1111111111111111
1000000000000001
10PC000000000001
1000000000000001
1000000000C00001
1000000000000001
1000C00000000001
1000000000000E01
1000000000C00001
1111111111111111