1111111111111111
1PC00000000000E1
1111111111111111