1111111111111111111111111111111111111111
1PC0000000000000000000000000000000000001
1111101111111111111111111111111111111111
11111CCCCCCCCCCCCCCCCCCCCCCCCC1CCCCCC1E1
1CCCCCCCCCCCCCCCCCCCCC1CCCCCCCCCCC111101
1CCCCCCCCCCCCC1111111111111111CCCCCCC101
1CCCCCC1CCCCCCCCCCCCCCCCCCCCCCCCCCCCC101
1000000000000000000000000000000000000001
1000000000000000000001111111111111111101
111111111111111111110000000000000000C101
11111111111111111111C1111111111111111101
1C00000000000000000001C00000000000000001
1111111111111111111111111111111111111111