111111111111111111111111111111111111
1P0000000000000000000000000000000001
111111111111111111111111111111111101
100000000000000000000000000000000101
101111111111111111111111111111110101
101000000000000C00000000000000010101
101011111111111111111111111111010101
101010000000000000000000000001010101
101010111111111111111111111101010101
101010100000000000000000000101010101
101010101111111111111111110101010101
101010101E00000000000000000101010101
101010101111111111111111111101010101
101010100000000000000000000001010101
101010111111111111111111111111010101
101010000000000000000000000000010101
101011111111111111111111111111110101
101000000000000000000000000000000101
101111111111111111111111111111111101
100000000000000000000000000000000001
111111111111111111111111111111111111